10,15,15,15,15,15,11,10,15,6,10,15,2,2,15,15,15,15,2,15,15,15,15,11,4,2,2,2,15,2,15,15,6,10,15,15,15,2,6,10,15,15,11,4,15,2,15,2,2,6,
14,10,6,4,15,15,8,14,10,15,0,6,14,1,15,15,15,11,1,2,15,2,2,9,11,14,3,14,4,12,5,4,15,0,2,2,2,0,2,9,2,15,9,2,2,0,6,14,1,6,
14,1,15,2,15,15,0,0,8,5,14,10,8,1,15,2,15,8,14,14,5,14,14,10,8,1,15,0,15,15,0,15,15,12,14,14,3,14,3,5,14,4,15,8,14,1,15,0,9,11,
1,0,2,0,2,11,14,14,14,14,14,14,14,1,2,0,2,0,8,14,13,8,14,14,14,14,5,14,10,2,0,2,15,15,0,9,15,0,15,9,0,15,6,14,14,1,6,14,5,14,
14,3,14,14,14,13,8,13,9,9,8,14,14,3,14,3,14,3,14,14,10,8,13,8,14,14,14,14,14,14,14,14,10,11,14,10,11,14,10,11,14,10,15,12,14,1,15,12,1,8,
1,2,8,14,13,15,0,15,15,15,0,0,9,15,9,0,9,15,0,8,14,1,11,1,8,14,14,1,8,1,12,1,8,14,14,14,14,14,14,14,14,13,15,2,9,12,10,15,8,14,
14,14,14,1,15,15,9,2,15,15,8,13,11,10,15,9,15,15,8,1,8,14,14,14,14,14,14,14,14,13,11,14,1,9,0,8,13,0,8,1,0,15,15,12,10,15,12,10,9,8,
14,1,12,14,10,15,15,9,15,2,0,2,0,9,2,15,15,15,8,14,13,0,12,14,13,12,14,13,0,2,9,8,14,5,14,13,2,8,13,8,14,10,2,15,8,10,15,12,5,14,
1,9,15,8,1,15,15,15,11,14,14,14,1,11,14,10,2,2,0,0,2,0,15,0,15,15,0,15,8,14,10,8,14,14,1,2,9,9,15,0,9,12,3,10,9,12,10,15,8,14,
3,10,15,8,1,2,2,11,14,14,14,14,14,14,14,14,14,14,14,14,14,14,5,14,10,11,14,10,8,14,14,1,0,12,13,8,10,15,2,9,15,2,15,12,10,15,0,15,8,14,
10,8,10,9,8,1,12,14,1,8,13,8,14,14,14,13,9,9,12,14,14,14,14,1,8,14,13,8,14,13,12,14,1,2,2,12,13,15,0,15,6,1,15,15,9,15,0,15,12,14,
14,14,14,10,0,8,10,12,14,1,6,14,14,1,0,15,15,15,15,8,13,8,14,14,14,1,15,12,13,15,11,14,14,14,14,4,2,15,0,15,15,9,2,15,15,15,0,15,15,8,
14,14,14,14,14,14,13,11,14,1,15,9,9,12,14,4,15,2,15,9,2,0,8,14,14,14,10,15,15,15,0,8,14,14,1,15,0,6,14,4,15,2,9,15,2,15,0,15,11,3,
14,13,0,8,13,0,2,8,13,9,15,2,15,15,0,15,15,0,15,6,14,14,14,13,8,14,13,15,15,15,8,1,8,14,14,10,0,15,0,15,15,9,2,2,9,15,9,2,0,11,
1,11,14,1,2,8,14,14,10,2,2,9,15,11,14,10,15,0,15,15,8,14,1,2,0,0,15,15,15,15,8,14,14,1,8,14,13,11,14,10,15,2,9,12,10,15,11,14,1,12,
14,1,8,14,14,14,14,14,14,1,12,10,11,13,9,9,11,14,10,15,8,14,14,14,3,14,4,15,2,15,8,14,1,8,14,14,10,9,12,14,5,13,15,15,12,5,14,14,13,11,
14,14,14,14,13,8,13,9,8,1,15,12,13,2,15,15,8,1,9,15,8,1,8,13,15,9,2,11,1,15,9,0,8,13,8,13,9,15,15,8,1,15,15,15,15,8,14,1,15,12,
14,1,9,0,15,0,15,6,14,13,15,2,15,9,2,11,13,9,2,15,0,12,1,15,15,15,8,14,14,4,15,12,1,2,9,11,10,15,15,8,1,15,15,15,15,0,0,0,15,11,
14,14,10,9,15,0,2,2,12,10,2,9,15,15,12,1,15,15,9,6,14,4,9,15,15,15,9,9,9,2,2,2,8,14,10,8,13,15,15,8,1,15,2,15,6,14,14,14,4,12,
1,9,9,15,15,12,14,13,15,9,8,4,2,11,10,9,2,15,15,15,0,15,15,15,15,15,15,11,5,3,14,13,9,0,9,9,15,15,15,0,0,2,12,4,2,8,1,9,15,6,
14,5,4,15,15,2,9,15,15,2,9,2,8,1,8,10,9,11,4,15,9,2,15,15,15,11,5,3,1,15,0,15,2,9,15,15,15,15,11,14,14,1,6,10,8,14,14,10,11,5,
13,0,15,15,11,1,15,15,11,1,11,14,14,14,14,14,10,9,15,2,15,0,15,15,11,14,1,11,1,6,14,4,9,2,15,15,15,11,14,14,13,8,5,14,1,12,1,8,1,8,
10,12,10,15,9,8,10,15,9,8,14,14,14,14,14,1,8,10,15,9,15,0,15,11,1,8,14,14,14,4,9,15,15,0,15,15,15,8,1,0,15,12,13,9,9,2,8,14,14,14,
14,10,9,15,6,1,9,15,6,1,8,1,8,14,13,12,1,8,10,15,15,9,11,14,14,1,9,8,14,10,15,15,15,0,15,15,6,14,14,1,15,2,15,15,15,12,14,14,14,14,
1,0,2,15,15,0,2,15,2,12,13,12,14,13,11,4,8,14,14,10,2,11,14,14,14,13,11,3,14,1,15,2,15,9,15,2,15,8,14,13,15,0,15,15,15,2,12,14,14,14,
14,3,14,4,2,12,14,4,0,15,15,11,14,4,0,2,8,1,8,14,14,14,1,0,12,10,9,15,8,3,4,9,15,15,2,12,10,12,13,2,15,9,15,15,15,9,2,9,12,3,
1,2,9,15,9,15,9,15,8,10,15,12,14,10,12,14,14,14,14,14,14,14,14,14,10,9,11,10,0,2,15,2,15,11,1,15,0,15,11,1,15,15,2,15,15,11,1,15,2,6,
13,8,4,15,15,2,15,15,0,9,15,6,1,0,11,14,14,14,14,13,0,12,1,8,1,15,0,12,14,14,5,13,15,0,12,5,13,11,1,9,2,15,0,15,15,9,9,11,13,11,
10,9,15,15,15,12,10,15,8,10,15,11,14,13,8,1,0,8,13,15,0,15,12,14,13,11,1,15,8,14,1,15,2,9,15,8,10,12,14,10,8,10,9,2,6,4,2,9,11,14,
1,15,15,15,11,10,12,10,8,14,4,0,8,10,9,12,14,13,15,15,0,15,15,12,5,13,0,11,3,14,1,15,9,15,15,8,13,11,13,0,9,0,11,1,2,15,9,11,14,14,
13,2,15,15,0,9,15,8,13,0,15,8,14,1,15,2,9,15,2,6,13,2,15,15,9,11,14,1,15,8,1,15,2,2,15,8,10,9,15,0,11,3,13,8,14,10,2,8,14,14,
10,9,15,11,14,10,15,0,2,0,2,8,1,8,4,9,15,2,9,15,15,0,15,15,15,12,14,1,2,8,1,2,12,13,2,8,14,10,15,0,9,15,15,8,14,1,12,1,12,14,
13,2,15,9,9,9,15,12,14,14,14,14,14,13,2,2,15,9,15,15,2,9,15,2,15,15,12,14,14,14,14,1,2,2,8,14,14,1,2,9,2,2,11,14,13,12,10,0,2,12,
10,12,4,15,15,15,2,15,9,12,13,8,14,10,12,13,2,15,15,15,0,2,15,8,4,2,2,8,14,14,13,8,3,3,1,12,1,12,1,15,0,12,1,0,15,11,14,14,13,11,
1,15,15,15,15,15,8,10,6,4,15,9,0,9,2,15,12,4,2,15,8,14,4,0,2,12,14,14,14,1,15,0,15,15,0,15,0,11,13,11,1,15,8,13,2,8,14,14,10,12,
14,10,15,15,15,15,8,14,10,15,2,2,8,10,9,15,15,6,14,10,12,13,11,14,1,11,14,14,13,9,15,0,15,15,9,15,8,13,11,13,0,11,13,2,12,1,12,14,13,11,
14,1,15,2,15,15,8,14,14,5,14,14,14,1,15,2,15,15,8,13,2,15,8,14,14,14,13,9,15,15,15,0,15,15,15,11,13,11,1,11,14,1,2,12,10,9,15,9,2,12,
3,1,2,0,2,11,1,8,14,14,3,14,14,1,2,0,15,2,8,4,0,2,12,14,14,1,15,15,15,2,15,0,2,11,5,14,10,12,14,3,14,13,8,10,0,15,15,15,9,11,
5,3,14,14,14,13,8,13,9,9,2,0,8,3,14,14,10,12,13,2,12,13,2,9,9,9,15,15,11,13,2,12,14,13,8,1,0,2,9,15,0,15,0,8,14,10,15,15,2,12,
1,2,0,8,13,15,9,2,15,15,8,14,1,15,9,9,9,15,2,9,15,15,9,2,15,15,2,2,9,15,0,15,0,15,8,14,14,13,15,15,9,15,12,1,9,9,2,15,9,6,
14,14,14,13,2,15,15,9,15,15,8,14,14,4,15,15,2,11,14,10,11,10,15,9,15,15,0,9,15,15,0,11,14,10,8,14,13,15,15,2,15,15,15,9,15,15,9,2,15,11,
14,1,0,11,1,15,2,15,15,11,14,14,1,15,15,2,12,14,13,8,14,14,4,15,15,15,0,2,2,15,12,14,13,12,14,1,15,15,15,12,10,15,15,2,15,2,15,9,2,12,
1,8,14,1,0,15,9,15,11,14,14,14,1,15,15,0,15,0,15,8,14,1,15,15,2,2,12,14,13,2,15,0,15,2,9,0,2,15,15,15,0,15,15,8,5,1,15,15,12,5,
14,14,14,3,1,2,2,11,14,1,9,0,8,10,6,13,11,14,10,8,14,13,15,15,12,1,15,0,15,9,11,14,10,8,10,8,13,15,2,15,12,10,15,8,1,9,15,15,15,8,
14,1,0,15,8,14,14,14,14,14,4,8,14,1,15,15,0,12,14,13,9,2,15,15,2,9,6,14,10,15,0,12,14,13,8,1,2,15,8,10,15,12,10,8,14,4,15,15,15,8,
14,14,1,11,14,14,14,1,0,0,11,14,14,1,11,10,9,15,0,15,15,9,11,10,0,2,15,9,8,10,0,15,0,15,8,14,13,2,0,12,10,15,12,1,0,15,2,2,15,8,
14,14,14,14,1,12,14,14,14,13,9,9,9,12,14,13,2,11,14,10,15,11,13,8,14,3,10,11,1,8,1,11,14,10,0,9,11,13,0,15,0,15,2,8,1,2,12,1,2,8,
3,14,14,1,9,2,9,8,13,15,15,15,15,15,8,5,14,1,12,14,10,9,15,0,9,2,12,1,12,14,14,1,12,14,3,10,9,11,13,15,0,15,12,14,14,14,10,8,14,14,
4,0,9,9,15,0,15,9,2,11,10,11,10,11,14,14,14,1,15,9,9,2,15,9,11,1,15,9,15,8,14,1,15,0,15,9,2,9,15,6,1,15,2,12,13,8,14,3,1,12,
4,9,15,15,6,13,15,15,12,13,12,13,12,13,12,13,9,9,15,15,15,9,15,15,12,13,15,15,15,9,12,13,6,3,4,15,9,15,15,15,12,4,9,15,15,9,9,15,9,6